1111111111111111111111111111111
10C10C0C01111110000000000111111
10C10C0C01111110000000000000001
11C00C1101000000000000011111111
10010P0C00000000000000000000001
1011010000000000000000000000001
10C001C0E1000000000000000000001
1000000111C00000111111000000001
111111111C00000000000C000000111
1000000000000000000000000000001
1000000000000000000000000000001
1000000000000000000000000000001
1000000000000000000000000000001
1000000000000000000000000000001
1000000000000000000000000000001
1000000000000000000000000000001
1000000000000000000000000000001
11C00C1101000000000000011111111
1001000C00000000000000000000001
1011010000000000000000000000001
10C001C0E0000000000000000000001
1000000111C00000111111000000001
111111111C00000000000C000000111
1000000000000000000000000000001
1000000000000000000000000000001
1000000000000000000000000000001
1000000000000000000000000000001
1000000000000000000000000000001
1000000000000000000000000000001
1000000000000000000000000000001
1000000000000000000000000000001
1111111111111111111111111111111
