111111111
1EC10P001
10C100001
10C100001
10C100001
10C000001
111111111
